0000000000000000
0000000000000000
0000110000110000
0001110000111000
0011110000111100
0011110000111100
0011100000011100
0011000000001100
0011000000001100
0033000000003300
0011000000001100
0022000000002200
0000000000000000
0000000000000000
0000004455000000
0000004455000000
