11001111
11001111
00000033
00020034
00000000
01234567